2243690496, 31994780, 1252261888, 15973676, 991428608, 15994765
2243690496, 31994780, 1252261888, 15973676, 991428608, 15994765
2851864576, 40094486, 1860435968, 23962939, 991428608, 16099163
3297771520, 47994612, 1860435968, 23962939, 1437335552, 23993498
3297771520, 47994612, 1860435968, 23962939, 1437335552, 23993498
3297771520, 47994612, 1860435968, 23962939, 1437335552, 23993498
4488167424, 64081605, 3050831872, 39950834, 1437335552, 24089613
4488167424, 64081605, 3050831872, 39950834, 1437335552, 24089613
4914413568, 71994510, 3050831872, 39950834, 1863581696, 31997013
4914413568, 71994510, 3050831872, 39950834, 1863581696, 31997013
4914413568, 71994510, 3050831872, 39950834, 1863581696, 31997013
5781323776, 87985629, 3050831872, 39950834, 2730491904, 47988132
5781323776, 87985629, 3050831872, 39950834, 2730491904, 47988132
5781323776, 87985629, 3050831872, 39950834, 2730491904, 47988132
7037255680, 103982853, 4306763776, 55948058, 2730491904, 47988132
7250116608, 107994630, 4306763776, 55948058, 2943352832, 51992992
7250116608, 107994630, 4306763776, 55948058, 2943352832, 51992992
7250116608, 107994630, 4306763776, 55948058, 2943352832, 51992992
8411414528, 123982535, 5468061696, 71935963, 2943352832, 51992992
8411414528, 123982535, 5468061696, 71935963, 2943352832, 51992992
8411414528, 123982535, 5468061696, 71935963, 2943352832, 51992992
9317384192, 139984974, 5468061696, 71935963, 3849322496, 67995431
9317384192, 139984974, 5468061696, 71935963, 3849322496, 67995431
9317384192, 139984974, 5468061696, 71935963, 3849322496, 67995431
10438836224, 155982467, 6589513728, 87933456, 3849322496, 67995431
10438836224, 155982467, 6589513728, 87933456, 3849322496, 67995431
10438836224, 155982467, 6589513728, 87933456, 3849322496, 67995431
11385176064, 171984544, 6589513728, 87933456, 4795662336, 83997508
11385176064, 171984544, 6589513728, 87933456, 4795662336, 83997508
11385176064, 171984544, 6589513728, 87933456, 4795662336, 83997508
12574523392, 187982529, 7778861056, 103931441, 4795662336, 83997508
12574523392, 187982529, 7778861056, 103931441, 4795662336, 83997508
12574523392, 187982529, 7778861056, 103931441, 4795662336, 83997508
13438812160, 203985345, 7778861056, 103931441, 5659951104, 100000324
13438812160, 203985345, 7778861056, 103931441, 5659951104, 100000324
13438812160, 203985345, 7778861056, 103931441, 5659951104, 100000324
13438812160, 203985345, 7778861056, 103931441, 5659951104, 100000324
14591721472, 219982512, 8931770368, 119928608, 5659951104, 100000324
14591721472, 219982512, 8931770368, 119928608, 5659951104, 100000324
14591721472, 219982512, 8931770368, 119928608, 5659951104, 100000324
15530196992, 235984821, 8931770368, 119928608, 6598426624, 116002633
15530196992, 235984821, 8931770368, 119928608, 6598426624, 116002633
15530196992, 235984821, 8931770368, 119928608, 6598426624, 116002633
16711417856, 251982383, 10112991232, 135926170, 6598426624, 116002633
16711417856, 251982383, 10112991232, 135926170, 6598426624, 116002633
16711417856, 251982383, 10112991232, 135926170, 6598426624, 116002633
17607950336, 267984723, 10112991232, 135926170, 7494959104, 132004973
17607950336, 267984723, 10112991232, 135926170, 7494959104, 132004973
17607950336, 267984723, 10112991232, 135926170, 7494959104, 132004973
18788909056, 283982256, 11293949952, 151923703, 7494959104, 132004973
18788909056, 283982256, 11293949952, 151923703, 7494959104, 132004973
18788909056, 283982256, 11293949952, 151923703, 7494959104, 132004973
19684655104, 299984720, 11293949952, 151923703, 8390705152, 148007437
19684655104, 299984720, 11293949952, 151923703, 8390705152, 148007437
19684655104, 299984720, 11293949952, 151923703, 8390705152, 148007437
20800602112, 315982287, 12409896960, 167921270, 8390705152, 148007437
20800602112, 315982287, 12409896960, 167921270, 8390705152, 148007437
20800602112, 315982287, 12409896960, 167921270, 8390705152, 148007437
21733834752, 331985226, 12409896960, 167921270, 9323937792, 164010376
21733834752, 331985226, 12409896960, 167921270, 9323937792, 164010376
21733834752, 331985226, 12409896960, 167921270, 9323937792, 164010376
22929473536, 347982412, 13605535744, 183918456, 9323937792, 164010376
22929473536, 347982412, 13605535744, 183918456, 9323937792, 164010376
22929473536, 347982412, 13605535744, 183918456, 9323937792, 164010376
22929473536, 347982412, 13605535744, 183918456, 9323937792, 164010376
23784062976, 363996234, 13605535744, 183918456, 10178527232, 180016133
23784062976, 363996234, 13605535744, 183918456, 10178527232, 180016133
23784062976, 363996234, 13605535744, 183918456, 10178527232, 180016133
24948768768, 379982442, 14770241536, 199904664, 10178527232, 180016133
24948768768, 379982442, 14770241536, 199904664, 10178527232, 180016133
24948768768, 379982442, 14770241536, 199904664, 10178527232, 180016133
24948768768, 379982442, 14770241536, 199904664, 10178527232, 180016133
24948768768, 379982442, 14770241536, 199904664, 10178527232, 180016133
26571440128, 407985107, 14770241536, 199904664, 11801198592, 208018798
26571440128, 407985107, 14770241536, 199904664, 11801198592, 208018798
26571440128, 407985107, 14770241536, 199904664, 11801198592, 208018798
27750563840, 423982467, 15949365248, 215902024, 11801198592, 208018798
27750563840, 423982467, 15949365248, 215902024, 11801198592, 208018798
27750563840, 423982467, 15949365248, 215902024, 11801198592, 208018798
28410118144, 435985841, 15949365248, 215902024, 12460752896, 220022172
28410118144, 435985841, 15949365248, 215902024, 12460752896, 220022172
28410118144, 435985841, 15949365248, 215902024, 12460752896, 220022172
29593960448, 451982531, 17133207552, 231898714, 12460752896, 220022172
29593960448, 451982531, 17133207552, 231898714, 12460752896, 220022172
29593960448, 451982531, 17133207552, 231898714, 12460752896, 220022172
30502551552, 467984910, 17133207552, 231898714, 13369344000, 236024551
30502551552, 467984910, 17133207552, 231898714, 13369344000, 236024551
30502551552, 467984910, 17133207552, 231898714, 13369344000, 236024551
31613517824, 483982488, 18244173824, 247896292, 13369344000, 236024551
32110280704, 491997326, 18244173824, 247896292, 13866106880, 244030341
32110280704, 491997326, 18244173824, 247896292, 13866106880, 244030341
32110280704, 491997326, 18244173824, 247896292, 13866106880, 244030341
32110280704, 491997326, 18244173824, 247896292, 13866106880, 244030341
33276559360, 507982362, 19410452480, 263881328, 13866106880, 244030341
33276559360, 507982362, 19410452480, 263881328, 13866106880, 244030341
33276559360, 507982362, 19410452480, 263881328, 13866106880, 244030341
33276559360, 507982362, 19410452480, 263881328, 13866106880, 244030341
33276559360, 507982362, 19410452480, 263881328, 13866106880, 244030341
34835529728, 535986024, 19410452480, 263881328, 15425077248, 272034003
34835529728, 535986024, 19410452480, 263881328, 15425077248, 272034003
34835529728, 535986024, 19410452480, 263881328, 15425077248, 272034003
35962224640, 551982416, 20537147392, 279877720, 15425077248, 272034003
35962224640, 551982416, 20537147392, 279877720, 15425077248, 272034003
35962224640, 551982416, 20537147392, 279877720, 15425077248, 272034003
36926390272, 567984910, 20537147392, 279877720, 16389242880, 288036497
36926390272, 567984910, 20537147392, 279877720, 16389242880, 288036497
36926390272, 567984910, 20537147392, 279877720, 16389242880, 288036497
38117310464, 583982566, 21728067584, 295875376, 16389242880, 288036497
38117310464, 583982566, 21728067584, 295875376, 16389242880, 288036497
38117310464, 583982566, 21728067584, 295875376, 16389242880, 288036497
38973210624, 599984652, 21728067584, 295875376, 17245143040, 304038583
38973210624, 599984652, 21728067584, 295875376, 17245143040, 304038583
38973210624, 599984652, 21728067584, 295875376, 17245143040, 304038583
40162820096, 615982973, 22917677056, 311873697, 17245143040, 304038583
40378302464, 619994591, 22917677056, 311873697, 17460625408, 308043354
40378302464, 619994591, 22917677056, 311873697, 17460625408, 308043354
40378302464, 619994591, 22917677056, 311873697, 17460625408, 308043354
41545105408, 635982144, 24084480000, 327861250, 17460625408, 308043354
41545105408, 635982144, 24084480000, 327861250, 17460625408, 308043354
41545105408, 635982144, 24084480000, 327861250, 17460625408, 308043354
41545105408, 635982144, 24084480000, 327861250, 17460625408, 308043354
41545105408, 635982144, 24084480000, 327861250, 17460625408, 308043354
41545105408, 635982144, 24084480000, 327861250, 17460625408, 308043354
43084939264, 664484203, 24084480000, 327861250, 19000459264, 336545413
43084939264, 664484203, 24084480000, 327861250, 19000459264, 336545413
43084939264, 664484203, 24084480000, 327861250, 19000459264, 336545413
44277432320, 679982377, 25276973056, 343359424, 19000459264, 336545413
44277432320, 679982377, 25276973056, 343359424, 19000459264, 336545413
44277432320, 679982377, 25276973056, 343359424, 19000459264, 336545413
45097680896, 695984550, 25276973056, 343359424, 19820707840, 352547586
45097680896, 695984550, 25276973056, 343359424, 19820707840, 352547586
45097680896, 695984550, 25276973056, 343359424, 19820707840, 352547586
46333952000, 711982364, 26513244160, 359357238, 19820707840, 352547586
46333952000, 711982364, 26513244160, 359357238, 19820707840, 352547586
46333952000, 711982364, 26513244160, 359357238, 19820707840, 352547586
47004778496, 724096078, 26513244160, 359357238, 20491534336, 364661300
47004778496, 724096078, 26513244160, 359357238, 20491534336, 364661300
47004778496, 724096078, 26513244160, 359357238, 20491534336, 364661300
48117579776, 739982430, 27626045440, 375243590, 20491534336, 364661300
48117579776, 739982430, 27626045440, 375243590, 20491534336, 364661300
48117579776, 739982430, 27626045440, 375243590, 20491534336, 364661300
49060249600, 755983834, 27626045440, 375243590, 21434204160, 380662704
49060249600, 755983834, 27626045440, 375243590, 21434204160, 380662704
49060249600, 755983834, 27626045440, 375243590, 21434204160, 380662704
50241994752, 771982231, 28807790592, 391241987, 21434204160, 380662704
50672435200, 779994249, 28807790592, 391241987, 21864644608, 388667991
50672435200, 779994249, 28807790592, 391241987, 21864644608, 388667991
50672435200, 779994249, 28807790592, 391241987, 21864644608, 388667991
51841597440, 795982223, 29976952832, 407229961, 21864644608, 388667991
51841597440, 795982223, 29976952832, 407229961, 21864644608, 388667991
51841597440, 795982223, 29976952832, 407229961, 21864644608, 388667991
51841597440, 795982223, 29976952832, 407229961, 21864644608, 388667991
52679933952, 811983758, 29976952832, 407229961, 22702981120, 404669526
52679933952, 811983758, 29976952832, 407229961, 22702981120, 404669526
52679933952, 811983758, 29976952832, 407229961, 22702981120, 404669526
53909651456, 827982375, 31206670336, 423228578, 22702981120, 404669526
53909651456, 827982375, 31206670336, 423228578, 22702981120, 404669526
53909651456, 827982375, 31206670336, 423228578, 22702981120, 404669526
54815621120, 843984646, 31206670336, 423228578, 23608950784, 420671797
54815621120, 843984646, 31206670336, 423228578, 23608950784, 420671797
54815621120, 843984646, 31206670336, 423228578, 23608950784, 420671797
55981899776, 859982287, 32372948992, 439226219, 23608950784, 420671797
55981899776, 859982287, 32372948992, 439226219, 23608950784, 420671797
55981899776, 859982287, 32372948992, 439226219, 23608950784, 420671797
55981899776, 859982287, 32372948992, 439226219, 23608950784, 420671797
55981899776, 859982287, 32372948992, 439226219, 23608950784, 420671797
57513607168, 887984688, 32372948992, 439226219, 25140658176, 448674198
57513607168, 887984688, 32372948992, 439226219, 25140658176, 448674198
57513607168, 887984688, 32372948992, 439226219, 25140658176, 448674198
58710294528, 904040185, 33569636352, 455224482, 25140658176, 448726592
58710294528, 904040185, 33569636352, 455224482, 25140658176, 448726592
59274952704, 911993054, 33569636352, 455224482, 25705316352, 456672954
59274952704, 911993054, 33569636352, 455224482, 25705316352, 456672954
59274952704, 911993054, 33569636352, 455224482, 25705316352, 456672954
60459843584, 928106983, 34754527232, 471214005, 25705316352, 456794398
60459843584, 928106983, 34754527232, 471214005, 25705316352, 456794398
60891594752, 935993761, 34754527232, 471214005, 26137067520, 464674171
61319151616, 943992436, 34754527232, 471214005, 26564624384, 472667318
61319151616, 943992436, 34754527232, 471214005, 26564624384, 472667318
61319151616, 943992436, 34754527232, 471214005, 26564624384, 472667318
62432477184, 959982547, 35867852800, 487204116, 26564624384, 472667318
62432477184, 959982547, 35867852800, 487204116, 26564624384, 472667318
62432477184, 959982547, 35867852800, 487204116, 26564624384, 472667318
63644631040, 975983587, 35867852800, 487204116, 27776778240, 488668358
63644631040, 975983587, 35867852800, 487204116, 27776778240, 488668358
63644631040, 975983587, 35867852800, 487204116, 27776778240, 488668358
64345341952, 987985301, 36568563712, 499205830, 27776778240, 488668358
64345341952, 987985301, 36568563712, 499205830, 27776778240, 488668358
64345341952, 987985301, 36568563712, 499205830, 27776778240, 488668358
65533640704, 1003982239, 36568563712, 499205830, 28965076992, 504665296
65533640704, 1003982239, 36568563712, 499205830, 28965076992, 504665296
65533640704, 1003982239, 36568563712, 499205830, 28965076992, 504665296
66407366656, 1019984789, 37442289664, 515208380, 28965076992, 504665296
66407366656, 1019984789, 37442289664, 515208380, 28965076992, 504665296
66407366656, 1019984789, 37442289664, 515208380, 28965076992, 504665296
67616636928, 1035982243, 37442289664, 515208380, 30174347264, 520662750
67616636928, 1035982243, 37442289664, 515208380, 30174347264, 520662750
68268326912, 1047983978, 38093979648, 527210115, 30174347264, 520662750
68268326912, 1047983978, 38093979648, 527210115, 30174347264, 520662750
68268326912, 1047983978, 38093979648, 527210115, 30174347264, 520662750
68268326912, 1047983978, 38093979648, 527210115, 30174347264, 520662750
69463703552, 1063982924, 38093979648, 527210115, 31369723904, 536661696
69463703552, 1063982924, 38093979648, 527210115, 31369723904, 536661696
69463703552, 1063982924, 38093979648, 527210115, 31369723904, 536661696
70359449600, 1079983717, 38989725696, 543210908, 31369723904, 536661696
70359449600, 1079983717, 38989725696, 543210908, 31369723904, 536661696
70359449600, 1079983717, 38989725696, 543210908, 31369723904, 536661696
71547486208, 1095982260, 38989725696, 543210908, 32557760512, 552660239
71773192192, 1099995315, 39215431680, 547216539, 32557760512, 552660239
71773192192, 1099995315, 39215431680, 547216539, 32557760512, 552660239
71773192192, 1099995315, 39215431680, 547216539, 32557760512, 552660239
72640364544, 1115983564, 40082604032, 563204788, 32557760512, 552660239
72640364544, 1115983564, 40082604032, 563204788, 32557760512, 552660239
72640364544, 1115983564, 40082604032, 563204788, 32557760512, 552660239
73762340864, 1131989979, 40082604032, 563204788, 33679736832, 568661043
73762340864, 1131989979, 40082604032, 563204788, 33679736832, 568661043
73762340864, 1131989979, 40082604032, 563204788, 33679736832, 568661043
74683514880, 1147984484, 41003778048, 579199293, 33679736832, 568661043
74683514880, 1147984484, 41003778048, 579199293, 33679736832, 568661043
74683514880, 1147984484, 41003778048, 579199293, 33679736832, 568661043
75940757504, 1163982314, 41003778048, 579199293, 34936979456, 584658873
75940757504, 1163982314, 41003778048, 579199293, 34936979456, 584658873
75940757504, 1163982314, 41003778048, 579199293, 34936979456, 584658873
76800065536, 1179984447, 41863086080, 595201426, 34936979456, 584658873
76800065536, 1179984447, 41863086080, 595201426, 34936979456, 584658873
76800065536, 1179984447, 41863086080, 595201426, 34936979456, 584658873
77918371840, 1195982263, 41863086080, 595201426, 36055285760, 600656689
77918371840, 1195982263, 41863086080, 595201426, 36055285760, 600656689
77918371840, 1195982263, 41863086080, 595201426, 36055285760, 600656689
78889877504, 1211985274, 42834591744, 611204437, 36055285760, 600656689
78889877504, 1211985274, 42834591744, 611204437, 36055285760, 600656689
78889877504, 1211985274, 42834591744, 611204437, 36055285760, 600656689
80095739904, 1227982089, 42834591744, 611204437, 37261148160, 616653504
80095739904, 1227982089, 42834591744, 611204437, 37261148160, 616653504
80095739904, 1227982089, 42834591744, 611204437, 37261148160, 616653504
80095739904, 1227982089, 42834591744, 611204437, 37261148160, 616653504
80997777408, 1243984820, 43736629248, 627207168, 37261148160, 616653504
80997777408, 1243984820, 43736629248, 627207168, 37261148160, 616653504
80997777408, 1243984820, 43736629248, 627207168, 37261148160, 616653504
82182406144, 1259982234, 43736629248, 627207168, 38445776896, 632650918
82182406144, 1259982234, 43736629248, 627207168, 38445776896, 632650918
82182406144, 1259982234, 43736629248, 627207168, 38445776896, 632650918
83043811328, 1275984259, 44598034432, 643209193, 38445776896, 632650918
83043811328, 1275984259, 44598034432, 643209193, 38445776896, 632650918
83043811328, 1275984259, 44598034432, 643209193, 38445776896, 632650918
84169719808, 1291982075, 44598034432, 643209193, 39571685376, 648648734
84169719808, 1291982075, 44598034432, 643209193, 39571685376, 648648734
84923908096, 1303984931, 45352222720, 655212049, 39571685376, 648648734
84923908096, 1303984931, 45352222720, 655212049, 39571685376, 648648734
84923908096, 1303984931, 45352222720, 655212049, 39571685376, 648648734
86110633984, 1319982232, 45352222720, 655212049, 40758411264, 664646035
86110633984, 1319982232, 45352222720, 655212049, 40758411264, 664646035
86110633984, 1319982232, 45352222720, 655212049, 40758411264, 664646035
86110633984, 1319982232, 45352222720, 655212049, 40758411264, 664646035
86110633984, 1319982232, 45352222720, 655212049, 40758411264, 664646035
86110633984, 1319982232, 45352222720, 655212049, 40758411264, 664646035
87601971200, 1347984723, 46843559936, 683214540, 40758411264, 664646035
87601971200, 1347984723, 46843559936, 683214540, 40758411264, 664646035
87601971200, 1347984723, 46843559936, 683214540, 40758411264, 664646035
88845058048, 1363982160, 46843559936, 683214540, 42001498112, 680643472
88845058048, 1363982160, 46843559936, 683214540, 42001498112, 680643472
88845058048, 1363982160, 46843559936, 683214540, 42001498112, 680643472
89711968256, 1379984577, 47710470144, 699216957, 42001498112, 680643472
89711968256, 1379984577, 47710470144, 699216957, 42001498112, 680643472
89711968256, 1379984577, 47710470144, 699216957, 42001498112, 680643472
90903674880, 1395982381, 47710470144, 699216957, 43193204736, 696641276
90903674880, 1395982381, 47710470144, 699216957, 43193204736, 696641276
91594686464, 1407984892, 48401481728, 711219468, 43193204736, 696641276
91594686464, 1407984892, 48401481728, 711219468, 43193204736, 696641276
91594686464, 1407984892, 48401481728, 711219468, 43193204736, 696641276
91594686464, 1407984892, 48401481728, 711219468, 43193204736, 696641276
92792422400, 1423983092, 48401481728, 711219468, 44390940672, 712639476
92792422400, 1423983092, 48401481728, 711219468, 44390940672, 712639476
92792422400, 1423983092, 48401481728, 711219468, 44390940672, 712639476
93599825920, 1439985378, 49208885248, 727221754, 44390940672, 712639476
93599825920, 1439985378, 49208885248, 727221754, 44390940672, 712639476
93599825920, 1439985378, 49208885248, 727221754, 44390940672, 712639476
94843174912, 1455982340, 49208885248, 727221754, 45634289664, 728636438
94843174912, 1455982340, 49208885248, 727221754, 45634289664, 728636438
95517409280, 1467984863, 49883119616, 739224277, 45634289664, 728636438
95517409280, 1467984863, 49883119616, 739224277, 45634289664, 728636438
95517409280, 1467984863, 49883119616, 739224277, 45634289664, 728636438
96705183744, 1483998872, 49883119616, 739224277, 46822064128, 744637346
96705183744, 1483998872, 49883119616, 739224277, 46822064128, 744637346
96705183744, 1483998872, 49883119616, 739224277, 46822064128, 744637346
97574715392, 1499984585, 50752651264, 755209990, 46822064128, 744637346
97574715392, 1499984585, 50752651264, 755209990, 46822064128, 744637346
97574715392, 1499984585, 50752651264, 755209990, 46822064128, 744637346
98763800576, 1515982315, 50752651264, 755209990, 48011149312, 760635076
98763800576, 1515982315, 50752651264, 755209990, 48011149312, 760635076
98763800576, 1515982315, 50752651264, 755209990, 48011149312, 760635076
99470802944, 1527984836, 51459653632, 767212511, 48011149312, 760635076
99470802944, 1527984836, 51459653632, 767212511, 48011149312, 760635076
99470802944, 1527984836, 51459653632, 767212511, 48011149312, 760635076
100655955968, 1543982411, 51459653632, 767212511, 49196302336, 776632651
100655955968, 1543982411, 51459653632, 767212511, 49196302336, 776632651
100655955968, 1543982411, 51459653632, 767212511, 49196302336, 776632651
101516836864, 1559984222, 52320534528, 783214322, 49196302336, 776632651
101516836864, 1559984222, 52320534528, 783214322, 49196302336, 776632651
101516836864, 1559984222, 52320534528, 783214322, 49196302336, 776632651
102716932096, 1575982222, 52320534528, 783214322, 50396397568, 792630651
102938705920, 1580430418, 52542308352, 787657047, 50396397568, 792630651
102938705920, 1580430418, 52542308352, 787657047, 50396397568, 792630651
102938705920, 1580430418, 52542308352, 787657047, 50396397568, 792630651
103824752640, 1595984363, 53428355072, 803210992, 50396397568, 792630651
103824752640, 1595984363, 53428355072, 803210992, 50396397568, 792630651
103824752640, 1595984363, 53428355072, 803210992, 50396397568, 792630651
105023275008, 1611982215, 53428355072, 803210992, 51594919936, 808628503
105023275008, 1611982215, 53428355072, 803210992, 51594919936, 808628503
105023275008, 1611982215, 53428355072, 803210992, 51594919936, 808628503
105692266496, 1624442786, 54097346560, 815671563, 51594919936, 808628503
105692266496, 1624442786, 54097346560, 815671563, 51594919936, 808628503
105692266496, 1624442786, 54097346560, 815671563, 51594919936, 808628503
107063017472, 1643993523, 54329606144, 819660283, 52733411328, 824183511
107063017472, 1643993523, 54329606144, 819660283, 52733411328, 824183511
107063017472, 1643993523, 54329606144, 819660283, 52733411328, 824183511
107975802880, 1659984508, 55242391552, 835651268, 52733411328, 824183511
107975802880, 1659984508, 55242391552, 835651268, 52733411328, 824183511
107975802880, 1659984508, 55242391552, 835651268, 52733411328, 824183511
107975802880, 1659984508, 55242391552, 835651268, 52733411328, 824183511
109391118336, 1679993620, 55452631040, 839655689, 53938487296, 840181665
109391118336, 1679993620, 55452631040, 839655689, 53938487296, 840181665
109391118336, 1679993620, 55452631040, 839655689, 53938487296, 840181665
110233911296, 1695984629, 56295424000, 855646698, 53938487296, 840181665
110233911296, 1695984629, 56295424000, 855646698, 53938487296, 840181665
110233911296, 1695984629, 56295424000, 855646698, 53938487296, 840181665
110233911296, 1695984629, 56295424000, 855646698, 53938487296, 840181665
111415394304, 1711983096, 56295424000, 855646698, 55119970304, 856180132
111415394304, 1711983096, 56295424000, 855646698, 55119970304, 856180132
111415394304, 1711983096, 56295424000, 855646698, 55119970304, 856180132
112320053248, 1727984692, 57200082944, 871648294, 55119970304, 856180132
112320053248, 1727984692, 57200082944, 871648294, 55119970304, 856180132
112320053248, 1727984692, 57200082944, 871648294, 55119970304, 856180132
113573363712, 1743982422, 57200082944, 871648294, 56373280768, 872177862
113573363712, 1743982422, 57200082944, 871648294, 56373280768, 872177862
113573363712, 1743982422, 57200082944, 871648294, 56373280768, 872177862
114429788160, 1759984212, 58056507392, 887650084, 56373280768, 872177862
114429788160, 1759984212, 58056507392, 887650084, 56373280768, 872177862
114429788160, 1759984212, 58056507392, 887650084, 56373280768, 872177862
115631456256, 1775982279, 58056507392, 887650084, 57574948864, 888175929
115631456256, 1775982279, 58056507392, 887650084, 57574948864, 888175929
116302807040, 1787984543, 58727858176, 899652348, 57574948864, 888175929
116302807040, 1787984543, 58727858176, 899652348, 57574948864, 888175929
116302807040, 1787984543, 58727858176, 899652348, 57574948864, 888175929
117482192896, 1803982263, 58727858176, 899652348, 58754334720, 904173649
117482192896, 1803982263, 58727858176, 899652348, 58754334720, 904173649
117482192896, 1803982263, 58727858176, 899652348, 58754334720, 904173649
117482192896, 1803982263, 58727858176, 899652348, 58754334720, 904173649
118296412160, 1819983861, 59542077440, 915653946, 58754334720, 904173649
118296412160, 1819983861, 59542077440, 915653946, 58754334720, 904173649
118296412160, 1819983861, 59542077440, 915653946, 58754334720, 904173649
119551819776, 1835982367, 59542077440, 915653946, 60009742336, 920172155
119551819776, 1835982367, 59542077440, 915653946, 60009742336, 920172155
120243093504, 1847985085, 60233351168, 927656664, 60009742336, 920172155
120243093504, 1847985085, 60233351168, 927656664, 60009742336, 920172155
120243093504, 1847985085, 60233351168, 927656664, 60009742336, 920172155
121410158592, 1863982307, 60233351168, 927656664, 61176807424, 936169377
121410158592, 1863982307, 60233351168, 927656664, 61176807424, 936169377
121410158592, 1863982307, 60233351168, 927656664, 61176807424, 936169377
121410158592, 1863982307, 60233351168, 927656664, 61176807424, 936169377
121410158592, 1863982307, 60233351168, 927656664, 61176807424, 936169377
121410158592, 1863982307, 60233351168, 927656664, 61176807424, 936169377
123259584512, 1896082908, 61773971456, 955659200, 61485613056, 940262393
123259584512, 1896082908, 61773971456, 955659200, 61485613056, 940262393
123853078528, 1903986209, 61773971456, 955659200, 62079107072, 948162403
123853078528, 1903986209, 61773971456, 955659200, 62079107072, 948162403
123853078528, 1903986209, 61773971456, 955659200, 62079107072, 948162403
124894052352, 1919985040, 61773971456, 955659200, 63120080896, 964161234
124894052352, 1919985040, 61773971456, 955659200, 63120080896, 964161234
124894052352, 1919985040, 61773971456, 955659200, 63120080896, 964161234
125760176128, 1935984577, 62640095232, 971658737, 63120080896, 964161234
125760176128, 1935984577, 62640095232, 971658737, 63120080896, 964161234
125760176128, 1935984577, 62640095232, 971658737, 63120080896, 964161234
126589075456, 1951983976, 62640095232, 971658737, 63948980224, 980160633
126589075456, 1951983976, 62640095232, 971658737, 63948980224, 980160633
126589075456, 1951983976, 62640095232, 971658737, 63948980224, 980160633
127686410240, 1967983971, 63737430016, 987658732, 63948980224, 980160633
127686410240, 1967983971, 63737430016, 987658732, 63948980224, 980160633
127686410240, 1967983971, 63737430016, 987658732, 63948980224, 980160633
128344391680, 1979983973, 63737430016, 987658732, 64606961664, 992160635
128344391680, 1979983973, 63737430016, 987658732, 64606961664, 992160635
128344391680, 1979983973, 63737430016, 987658732, 64606961664, 992160635
129457979392, 1995982360, 64851017728, 1003657119, 64606961664, 992160635
129457979392, 1995982360, 64851017728, 1003657119, 64606961664, 992160635
129457979392, 1995982360, 64851017728, 1003657119, 64606961664, 992160635
130403270656, 2011984133, 64851017728, 1003657119, 65552252928, 1008162408
130403270656, 2011984133, 64851017728, 1003657119, 65552252928, 1008162408
130403270656, 2011984133, 64851017728, 1003657119, 65552252928, 1008162408
131573481472, 2027982345, 66021228544, 1019655331, 65552252928, 1008162408
131573481472, 2027982345, 66021228544, 1019655331, 65552252928, 1008162408
131573481472, 2027982345, 66021228544, 1019655331, 65552252928, 1008162408
132478926848, 2043984623, 66021228544, 1019655331, 66457698304, 1024164686
132478926848, 2043984623, 66021228544, 1019655331, 66457698304, 1024164686
132478926848, 2043984623, 66021228544, 1019655331, 66457698304, 1024164686
133667487744, 2059982435, 67209789440, 1035653143, 66457698304, 1024164686
133667487744, 2059982435, 67209789440, 1035653143, 66457698304, 1024164686
134317604864, 2071984193, 67209789440, 1035653143, 67107815424, 1036166444
134317604864, 2071984193, 67209789440, 1035653143, 67107815424, 1036166444
134317604864, 2071984193, 67209789440, 1035653143, 67107815424, 1036166444
134317604864, 2071984193, 67209789440, 1035653143, 67107815424, 1036166444
135496466432, 2087982736, 68388651008, 1051651686, 67107815424, 1036166444
135496466432, 2087982736, 68388651008, 1051651686, 67107815424, 1036166444
135496466432, 2087982736, 68388651008, 1051651686, 67107815424, 1036166444
136386445312, 2103983883, 68388651008, 1051651686, 67997794304, 1052167591
136386445312, 2103983883, 68388651008, 1051651686, 67997794304, 1052167591
136386445312, 2103983883, 68388651008, 1051651686, 67997794304, 1052167591
137576316928, 2119982617, 69578522624, 1067650420, 67997794304, 1052167591
137576316928, 2119982617, 69578522624, 1067650420, 67997794304, 1052167591
137576316928, 2119982617, 69578522624, 1067650420, 67997794304, 1052167591
138431692800, 2135984414, 69578522624, 1067650420, 68853170176, 1068169388
138431692800, 2135984414, 69578522624, 1067650420, 68853170176, 1068169388
138431692800, 2135984414, 69578522624, 1067650420, 68853170176, 1068169388
139605573632, 2151982240, 70752403456, 1083648246, 68853170176, 1068169388
139876892672, 2155993778, 70752403456, 1083648246, 69124489216, 1072174806
139876892672, 2155993778, 70752403456, 1083648246, 69124489216, 1072174806
139876892672, 2155993778, 70752403456, 1083648246, 69124489216, 1072174806
140747997184, 2171983778, 70752403456, 1083648246, 69995593728, 1088164806
140747997184, 2171983778, 70752403456, 1083648246, 69995593728, 1088164806
140747997184, 2171983778, 70752403456, 1083648246, 69995593728, 1088164806
141929480192, 2188004081, 71933886464, 1099668549, 69995593728, 1088164806
141929480192, 2188004081, 71933886464, 1099668549, 69995593728, 1088164806
141929480192, 2188004081, 71933886464, 1099668549, 69995593728, 1088164806
142819459072, 2203984449, 71933886464, 1099668549, 70885572608, 1104145174
142819459072, 2203984449, 71933886464, 1099668549, 70885572608, 1104145174
142819459072, 2203984449, 71933886464, 1099668549, 70885572608, 1104145174
144018505728, 2219982413, 73132933120, 1115666513, 70885572608, 1104145174
144018505728, 2219982413, 73132933120, 1115666513, 70885572608, 1104145174
144018505728, 2219982413, 73132933120, 1115666513, 70885572608, 1104145174
144865755136, 2235985080, 73132933120, 1115666513, 71732822016, 1120147841
144865755136, 2235985080, 73132933120, 1115666513, 71732822016, 1120147841
144865755136, 2235985080, 73132933120, 1115666513, 71732822016, 1120147841
146119327744, 2251982159, 74386505728, 1131663592, 71732822016, 1120147841
146119327744, 2251982159, 74386505728, 1131663592, 71732822016, 1120147841
146119327744, 2251982159, 74386505728, 1131663592, 71732822016, 1120147841
146770755584, 2263984355, 74386505728, 1131663592, 72384249856, 1132150037
146770755584, 2263984355, 74386505728, 1131663592, 72384249856, 1132150037
146770755584, 2263984355, 74386505728, 1131663592, 72384249856, 1132150037
147957481472, 2279982495, 75573231616, 1147661732, 72384249856, 1132150037
147957481472, 2279982495, 75573231616, 1147661732, 72384249856, 1132150037
147957481472, 2279982495, 75573231616, 1147661732, 72384249856, 1132150037
148852965376, 2295984778, 75573231616, 1147661732, 73279733760, 1148152320
148852965376, 2295984778, 75573231616, 1147661732, 73279733760, 1148152320
148852965376, 2295984778, 75573231616, 1147661732, 73279733760, 1148152320
149968912384, 2311982238, 76689178624, 1163659192, 73279733760, 1148152320
149968912384, 2311982238, 76689178624, 1163659192, 73279733760, 1148152320
149968912384, 2311982238, 76689178624, 1163659192, 73279733760, 1148152320
150842376192, 2327984132, 76689178624, 1163659192, 74153197568, 1164154214
150842376192, 2327984132, 76689178624, 1163659192, 74153197568, 1164154214
150842376192, 2327984132, 76689178624, 1163659192, 74153197568, 1164154214
152018878464, 2343982368, 77865680896, 1179657428, 74153197568, 1164154214
152018878464, 2343982368, 77865680896, 1179657428, 74153197568, 1164154214
152018878464, 2343982368, 77865680896, 1179657428, 74153197568, 1164154214
152926158848, 2359983798, 77865680896, 1179657428, 75060477952, 1180155644
152926158848, 2359983798, 77865680896, 1179657428, 75060477952, 1180155644
152926158848, 2359983798, 77865680896, 1179657428, 75060477952, 1180155644
152926158848, 2359983798, 77865680896, 1179657428, 75060477952, 1180155644
154380533760, 2379994733, 79108243456, 1195656757, 75272290304, 1184160170
154380533760, 2379994733, 79108243456, 1195656757, 75272290304, 1184160170
154380533760, 2379994733, 79108243456, 1195656757, 75272290304, 1184160170
154380533760, 2379994733, 79108243456, 1195656757, 75272290304, 1184160170
155267366912, 2396481051, 79108243456, 1195656757, 76159123456, 1200646488
155267366912, 2396481051, 79108243456, 1195656757, 76159123456, 1200646488
155267366912, 2396481051, 79108243456, 1195656757, 76159123456, 1200646488
156387508224, 2411982719, 80228384768, 1211158425, 76159123456, 1200646488
156387508224, 2411982719, 80228384768, 1211158425, 76159123456, 1200646488
156387508224, 2411982719, 80228384768, 1211158425, 76159123456, 1200646488
157339877376, 2427983454, 80228384768, 1211158425, 77111492608, 1216647223
157339877376, 2427983454, 80228384768, 1211158425, 77111492608, 1216647223
157339877376, 2427983454, 80228384768, 1211158425, 77111492608, 1216647223
158531846144, 2444091326, 81420353536, 1227157243, 77111492608, 1216751182
158959403008, 2451991793, 81420353536, 1227157243, 77539049472, 1224645794
158959403008, 2451991793, 81420353536, 1227157243, 77539049472, 1224645794
158959403008, 2451991793, 81420353536, 1227157243, 77539049472, 1224645794
160142721024, 2467982343, 82603671552, 1243147793, 77539049472, 1224645794
160142721024, 2467982343, 82603671552, 1243147793, 77539049472, 1224645794
160603045888, 2475999291, 82603671552, 1243147793, 77999374336, 1232652452
160603045888, 2475999291, 82603671552, 1243147793, 77999374336, 1232652452
161247920128, 2487996679, 82603671552, 1243147793, 78644248576, 1244644404
161247920128, 2487996679, 82603671552, 1243147793, 78644248576, 1244644404
161851113472, 2495986155, 83206864896, 1251134158, 78644248576, 1244644404
161851113472, 2495986155, 83206864896, 1251134158, 78644248576, 1244644404
161851113472, 2495986155, 83206864896, 1251134158, 78644248576, 1244644404
162756034560, 2511984442, 83206864896, 1251134158, 79549169664, 1260642691
162756034560, 2511984442, 83206864896, 1251134158, 79549169664, 1260642691
162756034560, 2511984442, 83206864896, 1251134158, 79549169664, 1260642691
163954294784, 2527982401, 84405125120, 1267132117, 79549169664, 1260642691
163954294784, 2527982401, 84405125120, 1267132117, 79549169664, 1260642691
163954294784, 2527982401, 84405125120, 1267132117, 79549169664, 1260642691
164816748544, 2543984305, 84405125120, 1267132117, 80411623424, 1276644595
165128962048, 2548096720, 84717338624, 1271240121, 80411623424, 1276644595
165128962048, 2548096720, 84717338624, 1271240121, 80411623424, 1276644595
165648793600, 2555986132, 85237170176, 1279126335, 80411623424, 1276644595
166308085760, 2563985436, 85896462336, 1287122846, 80411623424, 1276644595
166308085760, 2563985436, 85896462336, 1287122846, 80411623424, 1276644595
166308085760, 2563985436, 85896462336, 1287122846, 80411623424, 1276644595
167190986752, 2579984430, 85896462336, 1287122846, 81294524416, 1292643589
167190986752, 2579984430, 85896462336, 1287122846, 81294524416, 1292643589
167190986752, 2579984430, 85896462336, 1287122846, 81294524416, 1292643589
168371945472, 2595982296, 87077421056, 1303120712, 81294524416, 1292643589
168371945472, 2595982296, 87077421056, 1303120712, 81294524416, 1292643589
168371945472, 2595982296, 87077421056, 1303120712, 81294524416, 1292643589
169238593536, 2611983921, 87077421056, 1303120712, 82161172480, 1308645214
169238593536, 2611983921, 87077421056, 1303120712, 82161172480, 1308645214
169238593536, 2611983921, 87077421056, 1303120712, 82161172480, 1308645214
169238593536, 2611983921, 87077421056, 1303120712, 82161172480, 1308645214
170358734848, 2627982875, 88197562368, 1319119666, 82161172480, 1308645214
170358734848, 2627982875, 88197562368, 1319119666, 82161172480, 1308645214
170358734848, 2627982875, 88197562368, 1319119666, 82161172480, 1308645214
171256578048, 2643984349, 88197562368, 1319119666, 83059015680, 1324646688
171256578048, 2643984349, 88197562368, 1319119666, 83059015680, 1324646688
171256578048, 2643984349, 88197562368, 1319119666, 83059015680, 1324646688
172414730240, 2659982292, 89355714560, 1335117609, 83059015680, 1324646688
172907823104, 2667993551, 89355714560, 1335117609, 83552108544, 1332651251
172907823104, 2667993551, 89355714560, 1335117609, 83552108544, 1332651251
172907823104, 2667993551, 89355714560, 1335117609, 83552108544, 1332651251
174083014656, 2683982297, 90530906112, 1351106355, 83552108544, 1332651251
174083014656, 2684263672, 90530906112, 1351106355, 83552108544, 1332870746
176562896896, 2724475629, 91707932672, 1367103114, 84854964224, 1357034174
176562896896, 2724475629, 91707932672, 1367103114, 84854964224, 1357034174
176562896896, 2724475629, 91707932672, 1367103114, 84854964224, 1357034174
177473585152, 2739983905, 91707932672, 1367103114, 85765652480, 1372542450
177473585152, 2739983905, 91707932672, 1367103114, 85765652480, 1372542450
177473585152, 2739983905, 91707932672, 1367103114, 85765652480, 1372542450
178656378880, 2755982410, 92890726400, 1383101619, 85765652480, 1372542450
178656378880, 2755982410, 92890726400, 1383101619, 85765652480, 1372542450
178656378880, 2755982410, 92890726400, 1383101619, 85765652480, 1372542450
179532726272, 2771984719, 92890726400, 1383101619, 86641999872, 1388544759
179532726272, 2771984719, 92890726400, 1383101619, 86641999872, 1388544759
179532726272, 2771984719, 92890726400, 1383101619, 86641999872, 1388544759
180721287168, 2787985358, 94079287296, 1399102258, 86641999872, 1388544759
180721287168, 2787985358, 94079287296, 1399102258, 86641999872, 1388544759
181181087744, 2795996672, 94079287296, 1399102258, 87101800448, 1396547635
181181087744, 2795996672, 94079287296, 1399102258, 87101800448, 1396547635
181181087744, 2795996672, 94079287296, 1399102258, 87101800448, 1396547635
182357065728, 2811982209, 95255265280, 1415087795, 87101800448, 1396547635
182357065728, 2811982209, 95255265280, 1415087795, 87101800448, 1396547635
182357065728, 2811982209, 95255265280, 1415087795, 87101800448, 1396547635
183215325184, 2827983835, 95255265280, 1415087795, 87960059904, 1412549261
183215325184, 2827983835, 95255265280, 1415087795, 87960059904, 1412549261
184041865216, 2839994950, 96081805312, 1427093959, 87960059904, 1412549261
184041865216, 2839994950, 96081805312, 1427093959, 87960059904, 1412549261
184613076992, 2847994178, 96081805312, 1427093959, 88531271680, 1420541630
185062916096, 2856114710, 96081805312, 1427093959, 88981110784, 1428656777
185062916096, 2856114710, 96081805312, 1427093959, 88981110784, 1428656777
185606864896, 2863986188, 96625754112, 1434962503, 88981110784, 1428656777
185606864896, 2863986188, 96625754112, 1434962503, 88981110784, 1428656777
185606864896, 2863986188, 96625754112, 1434962503, 88981110784, 1428656777
186533806080, 2879984110, 96625754112, 1434962503, 89908051968, 1444654699
186533806080, 2879984110, 96625754112, 1434962503, 89908051968, 1444654699
186533806080, 2879984110, 96625754112, 1434962503, 89908051968, 1444654699
187742552064, 2895982576, 97834500096, 1450960969, 89908051968, 1444654699
187742552064, 2895982576, 97834500096, 1450960969, 89908051968, 1444654699
187742552064, 2895982576, 97834500096, 1450960969, 89908051968, 1444654699
188865314816, 2911983263, 97834500096, 1450960969, 91030814720, 1460655386
188865314816, 2911983263, 97834500096, 1450960969, 91030814720, 1460655386
188865314816, 2911983263, 97834500096, 1450960969, 91030814720, 1460655386
189888462848, 2927982570, 98857648128, 1466960276, 91030814720, 1460655386
189888462848, 2927982570, 98857648128, 1466960276, 91030814720, 1460655386
189888462848, 2927982570, 98857648128, 1466960276, 91030814720, 1460655386
191043469312, 2943982000, 98857648128, 1466960276, 92185821184, 1476654816
191043469312, 2943982000, 98857648128, 1466960276, 92185821184, 1476654816
191043469312, 2943982000, 98857648128, 1466960276, 92185821184, 1476654816
191043469312, 2943982000, 98857648128, 1466960276, 92185821184, 1476654816
191043469312, 2943982000, 98857648128, 1466960276, 92185821184, 1476654816
191043469312, 2943982000, 98857648128, 1466960276, 92185821184, 1476654816
192533757952, 2971984542, 100347936768, 1494962818, 92185821184, 1476654816
192890798080, 2976019414, 100347936768, 1494962818, 92542861312, 1480683914
193490321408, 2983986608, 100347936768, 1494962818, 93142384640, 1488647646
193490321408, 2983986608, 100347936768, 1494962818, 93142384640, 1488647646
193490321408, 2983986608, 100347936768, 1494962818, 93142384640, 1488647646
194617278464, 2999982294, 100347936768, 1494962818, 94269341696, 1504643332
194832498688, 3004072790, 100563156992, 1499047800, 94269341696, 1504643332
194832498688, 3004072790, 100563156992, 1499047800, 94269341696, 1504643332
195272638464, 3012014052, 101003296768, 1506980865, 94269341696, 1504643332
195272638464, 3012014052, 101003296768, 1506980865, 94269341696, 1504643332
195272638464, 3012014052, 101003296768, 1506980865, 94269341696, 1504643332
196178083840, 3027984413, 101908742144, 1522951226, 94269341696, 1504643332
196178083840, 3027984413, 101908742144, 1522951226, 94269341696, 1504643332
196178083840, 3027984413, 101908742144, 1522951226, 94269341696, 1504643332
197362188288, 3043982304, 101908742144, 1522951226, 95453446144, 1520641223
197362188288, 3043982304, 101908742144, 1522951226, 95453446144, 1520641223
198012567552, 3055983979, 102559121408, 1534952901, 95453446144, 1520641223
198012567552, 3055983979, 102559121408, 1534952901, 95453446144, 1520641223
198012567552, 3055983979, 102559121408, 1534952901, 95453446144, 1520641223
199209779200, 3071982556, 102559121408, 1534952901, 96650657792, 1536639800
199209779200, 3071982556, 102559121408, 1534952901, 96650657792, 1536639800
199209779200, 3071982556, 102559121408, 1534952901, 96650657792, 1536639800
199855177728, 3083993708, 103204519936, 1546957862, 96650657792, 1536639800
199855177728, 3083993708, 103204519936, 1546957862, 96650657792, 1536639800
199855177728, 3083993708, 103204519936, 1546957862, 96650657792, 1536639800
201048457216, 3099983479, 103204519936, 1546957862, 97843937280, 1552629571
201048457216, 3099983479, 103204519936, 1546957862, 97843937280, 1552629571
201048457216, 3099983479, 103204519936, 1546957862, 97843937280, 1552629571
201927426048, 3115984410, 104083488768, 1562958793, 97843937280, 1552629571
201927426048, 3115984410, 104083488768, 1562958793, 97843937280, 1552629571
201927426048, 3115984410, 104083488768, 1562958793, 97843937280, 1552629571
203125686272, 3131982301, 104083488768, 1562958793, 99042197504, 1568627462
203125686272, 3131982301, 104083488768, 1562958793, 99042197504, 1568627462
203776065536, 3144094901, 104733868032, 1575071393, 99042197504, 1568627462
203776065536, 3144094901, 104733868032, 1575071393, 99042197504, 1568627462
203776065536, 3144094901, 104733868032, 1575071393, 99042197504, 1568627462
204984287232, 3159982097, 104733868032, 1575071393, 100250419200, 1584514658
204984287232, 3159982097, 104733868032, 1575071393, 100250419200, 1584514658
204984287232, 3159982097, 104733868032, 1575071393, 100250419200, 1584514658
204984287232, 3159982097, 104733868032, 1575071393, 100250419200, 1584514658
206079524864, 3179993507, 105829105664, 1595076241, 100250419200, 1584514658
206079524864, 3179993507, 105829105664, 1595076241, 100250419200, 1584514658
206079524864, 3179993507, 105829105664, 1595076241, 100250419200, 1584514658
207293513728, 3195982313, 105829105664, 1595076241, 101464408064, 1600503464
207293513728, 3195982313, 105829105664, 1595076241, 101464408064, 1600503464
207293513728, 3195982313, 105829105664, 1595076241, 101464408064, 1600503464
208137617408, 3211983915, 106673209344, 1611077843, 101464408064, 1600503464
208137617408, 3211983915, 106673209344, 1611077843, 101464408064, 1600503464
208137617408, 3211983915, 106673209344, 1611077843, 101464408064, 1600503464
208137617408, 3211983915, 106673209344, 1611077843, 101464408064, 1600503464
209383063552, 3227982841, 106673209344, 1611077843, 102709854208, 1616502390
209383063552, 3227982841, 106673209344, 1611077843, 102709854208, 1616502390
209383063552, 3227982841, 106673209344, 1611077843, 102709854208, 1616502390
210255478784, 3243984258, 107545624576, 1627079260, 102709854208, 1616502390
210255478784, 3243984258, 107545624576, 1627079260, 102709854208, 1616502390
210255478784, 3243984258, 107545624576, 1627079260, 102709854208, 1616502390
211469205504, 3259982230, 107545624576, 1627079260, 103923580928, 1632500362
211469205504, 3259982230, 107545624576, 1627079260, 103923580928, 1632500362
211469205504, 3259982230, 107545624576, 1627079260, 103923580928, 1632500362
212382515200, 3275984473, 108458934272, 1643081503, 103923580928, 1632500362
212382515200, 3275984473, 108458934272, 1643081503, 103923580928, 1632500362
212382515200, 3275984473, 108458934272, 1643081503, 103923580928, 1632500362
213512093696, 3291982258, 108458934272, 1643081503, 105053159424, 1648498147
213512093696, 3291982258, 108458934272, 1643081503, 105053159424, 1648498147
213512093696, 3291982258, 108458934272, 1643081503, 105053159424, 1648498147
214475997184, 3307987279, 109422837760, 1659086524, 105053159424, 1648498147
214475997184, 3307987279, 109422837760, 1659086524, 105053159424, 1648498147
214475997184, 3307987279, 109422837760, 1659086524, 105053159424, 1648498147
215666917376, 3323982257, 109422837760, 1659086524, 106244079616, 1664493125
215666917376, 3323982257, 109422837760, 1659086524, 106244079616, 1664493125
215666917376, 3323982257, 109422837760, 1659086524, 106244079616, 1664493125
216322801664, 3335983960, 110078722048, 1671088227, 106244079616, 1664493125
216322801664, 3335983960, 110078722048, 1671088227, 106244079616, 1664493125
216322801664, 3335983960, 110078722048, 1671088227, 106244079616, 1664493125
217510051840, 3351982284, 110078722048, 1671088227, 107431329792, 1680491449
217510051840, 3351982284, 110078722048, 1671088227, 107431329792, 1680491449
217510051840, 3351982284, 110078722048, 1671088227, 107431329792, 1680491449
218413400064, 3367984684, 110982070272, 1687090627, 107431329792, 1680491449
218413400064, 3367984684, 110982070272, 1687090627, 107431329792, 1680491449
218413400064, 3367984684, 110982070272, 1687090627, 107431329792, 1680491449
219558445056, 3383982046, 110982070272, 1687090627, 108576374784, 1696488811
219558445056, 3383982046, 110982070272, 1687090627, 108576374784, 1696488811
219558445056, 3383982046, 110982070272, 1687090627, 108576374784, 1696488811
219558445056, 3383982046, 110982070272, 1687090627, 108576374784, 1696488811
219558445056, 3383982046, 110982070272, 1687090627, 108576374784, 1696488811
221163028480, 3411985623, 112586653696, 1715094204, 108576374784, 1696488811
221163028480, 3411985623, 112586653696, 1715094204, 108576374784, 1696488811
221163028480, 3411985623, 112586653696, 1715094204, 108576374784, 1696488811
222359191552, 3427982192, 112586653696, 1715094204, 109772537856, 1712485380
222359191552, 3427982192, 112586653696, 1715094204, 109772537856, 1712485380
222359191552, 3427982192, 112586653696, 1715094204, 109772537856, 1712485380
222995939328, 3439985221, 113223401472, 1727097233, 109772537856, 1712485380
223303172096, 3444028647, 113223401472, 1727097233, 110079770624, 1716523006
223901646848, 3451986146, 113223401472, 1727097233, 110678245376, 1724477173
223901646848, 3451986146, 113223401472, 1727097233, 110678245376, 1724477173
223901646848, 3451986146, 113223401472, 1727097233, 110678245376, 1724477173
224804732928, 3467997117, 114126487552, 1743098113, 110678245376, 1724477173
224804732928, 3467997117, 114126487552, 1743098113, 110678245376, 1724477173
224804732928, 3467997117, 114126487552, 1743098113, 110678245376, 1724477173
226002731008, 3483982221, 114126487552, 1743098113, 111876243456, 1740462277
226002731008, 3483982221, 114126487552, 1743098113, 111876243456, 1740462277
226002731008, 3483982221, 114126487552, 1743098113, 111876243456, 1740462277
227210166272, 3499990271, 115028787200, 1755102065, 112181379072, 1744461058
227210166272, 3499990271, 115028787200, 1755102065, 112181379072, 1744461058
227210166272, 3499990271, 115028787200, 1755102065, 112181379072, 1744461058
228099096576, 3512085044, 115028787200, 1755102065, 113070309376, 1756550842
228527439872, 3519994623, 115457130496, 1763005202, 113070309376, 1756550842
228527439872, 3519994623, 115457130496, 1763005202, 113070309376, 1756550842
228527439872, 3519994623, 115457130496, 1763005202, 113070309376, 1756550842
229688475648, 3535982268, 115457130496, 1763005202, 114231345152, 1772538487
229688475648, 3535982268, 115457130496, 1763005202, 114231345152, 1772538487
229688475648, 3535982268, 115457130496, 1763005202, 114231345152, 1772538487
229688475648, 3535982268, 115457130496, 1763005202, 114231345152, 1772538487
229688475648, 3535982268, 115457130496, 1763005202, 114231345152, 1772538487
229688475648, 3535982268, 115457130496, 1763005202, 114231345152, 1772538487
231242203136, 3563994320, 117010857984, 1791010190, 114231345152, 1772538487
231242203136, 3563994320, 117010857984, 1791010190, 114231345152, 1772538487
231242203136, 3563994320, 117010857984, 1791010190, 114231345152, 1772538487
232445444096, 3579982501, 117010857984, 1791010190, 115434586112, 1788526668
232445444096, 3579982501, 117010857984, 1791010190, 115434586112, 1788526668
232445444096, 3579982501, 117010857984, 1791010190, 115434586112, 1788526668
233346695168, 3595984659, 117912109056, 1807012348, 115434586112, 1788526668
233346695168, 3595984659, 117912109056, 1807012348, 115434586112, 1788526668
233346695168, 3595984659, 117912109056, 1807012348, 115434586112, 1788526668
234536566784, 3611982236, 117912109056, 1807012348, 116624457728, 1804524245
234536566784, 3611982236, 117912109056, 1807012348, 116624457728, 1804524245
235174887424, 3623985306, 118550429696, 1819015418, 116624457728, 1804524245
235174887424, 3623985306, 118550429696, 1819015418, 116624457728, 1804524245
235174887424, 3623985306, 118550429696, 1819015418, 116624457728, 1804524245
235174887424, 3623985306, 118550429696, 1819015418, 116624457728, 1804524245
236358467584, 3639983047, 118550429696, 1819015418, 117808037888, 1820521986
236358467584, 3639983047, 118550429696, 1819015418, 117808037888, 1820521986
236358467584, 3639983047, 118550429696, 1819015418, 117808037888, 1820521986
237234290688, 3655985320, 119426252800, 1835017691, 117808037888, 1820521986
237234290688, 3655985320, 119426252800, 1835017691, 117808037888, 1820521986
237234290688, 3655985320, 119426252800, 1835017691, 117808037888, 1820521986
238360461312, 3671982454, 119426252800, 1835017691, 118934208512, 1836519120
238360461312, 3671982454, 119426252800, 1835017691, 118934208512, 1836519120
238360461312, 3671982454, 119426252800, 1835017691, 118934208512, 1836519120
239311781888, 3687985328, 120377573376, 1851020565, 118934208512, 1836519120
239630024704, 3691991317, 120377573376, 1851020565, 119252451328, 1840519440
239630024704, 3691991317, 120377573376, 1851020565, 119252451328, 1840519440
239630024704, 3691991317, 120377573376, 1851020565, 119252451328, 1840519440
240787652608, 3707982047, 120377573376, 1851020565, 120410079232, 1856510170
240787652608, 3707982047, 120377573376, 1851020565, 120410079232, 1856510170
241416798208, 3719984915, 121006718976, 1863023433, 120410079232, 1856510170
241416798208, 3719984915, 121006718976, 1863023433, 120410079232, 1856510170
241416798208, 3719984915, 121006718976, 1863023433, 120410079232, 1856510170
242600116224, 3735982286, 121006718976, 1863023433, 121593397248, 1872507541
242600116224, 3735982286, 121006718976, 1863023433, 121593397248, 1872507541
242600116224, 3735982286, 121006718976, 1863023433, 121593397248, 1872507541
243494289408, 3751985863, 121900892160, 1879027010, 121593397248, 1872507541
243494289408, 3751985863, 121900892160, 1879027010, 121593397248, 1872507541
243494289408, 3751985863, 121900892160, 1879027010, 121593397248, 1872507541
244668170240, 3767982226, 121900892160, 1879027010, 122767278080, 1888503904
244668170240, 3767982226, 121900892160, 1879027010, 122767278080, 1888503904
244668170240, 3767982226, 121900892160, 1879027010, 122767278080, 1888503904
244668170240, 3767982226, 121900892160, 1879027010, 122767278080, 1888503904
244668170240, 3767982226, 121900892160, 1879027010, 122767278080, 1888503904
244668170240, 3767982226, 121900892160, 1879027010, 122767278080, 1888503904
246212984832, 3795985229, 123445706752, 1907030013, 122767278080, 1888503904
246212984832, 3795985229, 123445706752, 1907030013, 122767278080, 1888503904
246212984832, 3795985229, 123445706752, 1907030013, 122767278080, 1888503904
247407575040, 3811982234, 123445706752, 1907030013, 123961868288, 1904500909
247407575040, 3811982234, 123445706752, 1907030013, 123961868288, 1904500909
247407575040, 3811982234, 123445706752, 1907030013, 123961868288, 1904500909
248207900672, 3827985217, 124246032384, 1923032996, 123961868288, 1904500909
248207900672, 3827985217, 124246032384, 1923032996, 123961868288, 1904500909
248207900672, 3827985217, 124246032384, 1923032996, 123961868288, 1904500909
249391218688, 3843982332, 124246032384, 1923032996, 125145186304, 1920498024
249391218688, 3843982332, 124246032384, 1923032996, 125145186304, 1920498024
249391218688, 3843982332, 124246032384, 1923032996, 125145186304, 1920498024
250357743616, 3859985575, 125212557312, 1939036239, 125145186304, 1920498024
250357743616, 3859985575, 125212557312, 1939036239, 125145186304, 1920498024
250357743616, 3859985575, 125212557312, 1939036239, 125145186304, 1920498024
251480506368, 3875985306, 125212557312, 1939036239, 126267949056, 1936497755
251480506368, 3875985306, 125212557312, 1939036239, 126267949056, 1936497755
251480506368, 3875985306, 125212557312, 1939036239, 126267949056, 1936497755
252344270848, 3891985403, 126076321792, 1955036336, 126267949056, 1936497755
252344270848, 3891985403, 126076321792, 1955036336, 126267949056, 1936497755
252344270848, 3891985403, 126076321792, 1955036336, 126267949056, 1936497755
252344270848, 3891985403, 126076321792, 1955036336, 126267949056, 1936497755
253217472512, 3907984354, 126076321792, 1955036336, 127141150720, 1952496706
253217472512, 3907984354, 126076321792, 1955036336, 127141150720, 1952496706
253217472512, 3907984354, 126076321792, 1955036336, 127141150720, 1952496706
254357274624, 3923984067, 127216123904, 1971036049, 127141150720, 1952496706
254357274624, 3923984067, 127216123904, 1971036049, 127141150720, 1952496706
254357274624, 3923984067, 127216123904, 1971036049, 127141150720, 1952496706
254357274624, 3923984067, 127216123904, 1971036049, 127141150720, 1952496706
254357274624, 3923984067, 127216123904, 1971036049, 127141150720, 1952496706
255865651200, 3951984574, 127216123904, 1971036049, 128649527296, 1980497213
255865651200, 3951984574, 127216123904, 1971036049, 128649527296, 1980497213
255865651200, 3951984574, 127216123904, 1971036049, 128649527296, 1980497213
257062862848, 3967982229, 128413335552, 1987033704, 128649527296, 1980497213
257062862848, 3967982229, 128413335552, 1987033704, 128649527296, 1980497213
257062862848, 3967982229, 128413335552, 1987033704, 128649527296, 1980497213
257969881088, 3983984999, 128413335552, 1987033704, 129556545536, 1996499983
257969881088, 3983984999, 128413335552, 1987033704, 129556545536, 1996499983
257969881088, 3983984999, 128413335552, 1987033704, 129556545536, 1996499983
259151364096, 3999982324, 129594818560, 2003031029, 129556545536, 1996499983
259151364096, 3999982324, 129594818560, 2003031029, 129556545536, 1996499983
259151364096, 3999982324, 129594818560, 2003031029, 129556545536, 1996499983
259151364096, 3999982324, 129594818560, 2003031029, 129556545536, 1996499983
259991797760, 4015984840, 129594818560, 2003031029, 130396979200, 2012502499
259991797760, 4015984840, 129594818560, 2003031029, 130396979200, 2012502499
259991797760, 4015984840, 129594818560, 2003031029, 130396979200, 2012502499
261234884608, 4031982471, 130837905408, 2019028660, 130396979200, 2012502499
261234884608, 4031982471, 130837905408, 2019028660, 130396979200, 2012502499
261234884608, 4031982471, 130837905408, 2019028660, 130396979200, 2012502499
262105464832, 4047984283, 130837905408, 2019028660, 131267559424, 2028504311
262105464832, 4047984283, 130837905408, 2019028660, 131267559424, 2028504311
262105464832, 4047984283, 130837905408, 2019028660, 131267559424, 2028504311
263289044992, 4063982351, 132021485568, 2035026728, 131267559424, 2028504311
263289044992, 4063982351, 132021485568, 2035026728, 131267559424, 2028504311
263972192256, 4075985052, 132021485568, 2035026728, 131950706688, 2040507012
263972192256, 4075985052, 132021485568, 2035026728, 131950706688, 2040507012
263972192256, 4075985052, 132021485568, 2035026728, 131950706688, 2040507012
265146073088, 4091982293, 133195366400, 2051023969, 131950706688, 2040507012
265146073088, 4091982293, 133195366400, 2051023969, 131950706688, 2040507012
265146073088, 4091982293, 133195366400, 2051023969, 131950706688, 2040507012
265783607296, 4103984642, 133195366400, 2051023969, 132588240896, 2052509361
265783607296, 4103984642, 133195366400, 2051023969, 132588240896, 2052509361
265783607296, 4103984642, 133195366400, 2051023969, 132588240896, 2052509361
266958536704, 4119982353, 134370295808, 2067021680, 132588240896, 2052509361
266958536704, 4119982353, 134370295808, 2067021680, 132588240896, 2052509361
267600527360, 4131984530, 134370295808, 2067021680, 133230231552, 2064511538
267600527360, 4131984530, 134370295808, 2067021680, 133230231552, 2064511538
267600527360, 4131984530, 134370295808, 2067021680, 133230231552, 2064511538
268788039680, 4147982303, 135557808128, 2083019453, 133230231552, 2064511538
268788039680, 4147982303, 135557808128, 2083019453, 133230231552, 2064511538
268788039680, 4147982303, 135557808128, 2083019453, 133230231552, 2064511538
269617201152, 4163984568, 135557808128, 2083019453, 134059393024, 2080513803
269617201152, 4163984568, 135557808128, 2083019453, 134059393024, 2080513803
269617201152, 4163984568, 135557808128, 2083019453, 134059393024, 2080513803
270840365056, 4179982535, 136780972032, 2099017420, 134059393024, 2080513803
270840365056, 4179982535, 136780972032, 2099017420, 134059393024, 2080513803
270840365056, 4179982535, 136780972032, 2099017420, 134059393024, 2080513803
271486550016, 4192406380, 136780972032, 2099017420, 134705577984, 2092937648
271486550016, 4192406380, 136780972032, 2099017420, 134705577984, 2092937648
272311255040, 4203990791, 137605677056, 2110596165, 134705577984, 2092937648
272311255040, 4203990791, 137605677056, 2110596165, 134705577984, 2092937648
272311255040, 4203990791, 137605677056, 2110596165, 134705577984, 2092937648
273209622528, 4219984148, 137605677056, 2110596165, 135603945472, 2108931005
273209622528, 4219984148, 137605677056, 2110596165, 135603945472, 2108931005
273209622528, 4219984148, 137605677056, 2110596165, 135603945472, 2108931005
274447990784, 4235982231, 138844045312, 2126594248, 135603945472, 2108931005
274447990784, 4235982231, 138844045312, 2126594248, 135603945472, 2108931005
274447990784, 4235982231, 138844045312, 2126594248, 135603945472, 2108931005
275339542528, 4251984859, 138844045312, 2126594248, 136495497216, 2124933633
275339542528, 4251984859, 138844045312, 2126594248, 136495497216, 2124933633
275339542528, 4251984859, 138844045312, 2126594248, 136495497216, 2124933633
276441858048, 4267982403, 139946360832, 2142591792, 136495497216, 2124933633
276441858048, 4267982403, 139946360832, 2142591792, 136495497216, 2124933633
276441858048, 4267982403, 139946360832, 2142591792, 136495497216, 2124933633
276441858048, 4267982403, 139946360832, 2142591792, 136495497216, 2124933633
277366177792, 4283983785, 139946360832, 2142591792, 137419816960, 2140935015
277366177792, 4283983785, 139946360832, 2142591792, 137419816960, 2140935015
277366177792, 4283983785, 139946360832, 2142591792, 137419816960, 2140935015
278558932992, 4299982336, 141139116032, 2158590343, 137419816960, 2140935015
278558932992, 4299982336, 141139116032, 2158590343, 137419816960, 2140935015
278558932992, 4299982336, 141139116032, 2158590343, 137419816960, 2140935015
279443931136, 4315984118, 141139116032, 2158590343, 138304815104, 2156936797
279443931136, 4315984118, 141139116032, 2158590343, 138304815104, 2156936797
279443931136, 4315984118, 141139116032, 2158590343, 138304815104, 2156936797
280614928384, 4331982400, 142310113280, 2174588625, 138304815104, 2156936797
280614928384, 4331982400, 142310113280, 2174588625, 138304815104, 2156936797
280614928384, 4331982400, 142310113280, 2174588625, 138304815104, 2156936797
281437274112, 4347984046, 142310113280, 2174588625, 139127160832, 2172938443
281437274112, 4347984046, 142310113280, 2174588625, 139127160832, 2172938443
281437274112, 4347984046, 142310113280, 2174588625, 139127160832, 2172938443
282669350912, 4363991573, 143542190080, 2190589782, 139127160832, 2172938443
282669350912, 4363991573, 143542190080, 2190589782, 139127160832, 2172938443
282669350912, 4363991573, 143542190080, 2190589782, 139127160832, 2172938443
283558805504, 4379984623, 143542190080, 2190589782, 140016615424, 2188931493
283558805504, 4379984623, 143542190080, 2190589782, 140016615424, 2188931493
283558805504, 4379984623, 143542190080, 2190589782, 140016615424, 2188931493
284738453504, 4395982147, 144721838080, 2206587306, 140016615424, 2188931493
284738453504, 4395982147, 144721838080, 2206587306, 140016615424, 2188931493
284738453504, 4395982147, 144721838080, 2206587306, 140016615424, 2188931493
285377560576, 4407984185, 144721838080, 2206587306, 140655722496, 2200933531
285377560576, 4407984185, 144721838080, 2206587306, 140655722496, 2200933531
285377560576, 4407984185, 144721838080, 2206587306, 140655722496, 2200933531
286553800704, 4423982413, 145898078208, 2222585534, 140655722496, 2200933531
286553800704, 4423982413, 145898078208, 2222585534, 140655722496, 2200933531
286553800704, 4423982413, 145898078208, 2222585534, 140655722496, 2200933531
287436439552, 4439983853, 145898078208, 2222585534, 141538361344, 2216934971
287436439552, 4439983853, 145898078208, 2222585534, 141538361344, 2216934971
287436439552, 4439983853, 145898078208, 2222585534, 141538361344, 2216934971
288625524736, 4455982313, 147087163392, 2238583994, 141538361344, 2216934971
288625524736, 4455982313, 147087163392, 2238583994, 141538361344, 2216934971
288625524736, 4455982313, 147087163392, 2238583994, 141538361344, 2216934971
288625524736, 4455982313, 147087163392, 2238583994, 141538361344, 2216934971
288625524736, 4455982313, 147087163392, 2238583994, 141538361344, 2216934971
290168242176, 4483984458, 147087163392, 2238583994, 143081078784, 2244937116
290168242176, 4483984458, 147087163392, 2238583994, 143081078784, 2244937116
290774319104, 4491992027, 147693240320, 2246584681, 143081078784, 2244937116
290774319104, 4491992027, 147693240320, 2246584681, 143081078784, 2244937116
290774319104, 4491992027, 147693240320, 2246584681, 143081078784, 2244937116
291839148032, 4507982168, 148758069248, 2262574822, 143081078784, 2244937116
291839148032, 4507982168, 148758069248, 2262574822, 143081078784, 2244937116
291839148032, 4507982168, 148758069248, 2262574822, 143081078784, 2244937116
292796760064, 4523984590, 148758069248, 2262574822, 144038690816, 2260939538
292796760064, 4523984590, 148758069248, 2262574822, 144038690816, 2260939538
292796760064, 4523984590, 148758069248, 2262574822, 144038690816, 2260939538
293905367040, 4539982274, 149866676224, 2278572506, 144038690816, 2260939538
293905367040, 4539982274, 149866676224, 2278572506, 144038690816, 2260939538
293905367040, 4539982274, 149866676224, 2278572506, 144038690816, 2260939538
294849347584, 4555984946, 149866676224, 2278572506, 144982671360, 2276942210
294849347584, 4555984946, 149866676224, 2278572506, 144982671360, 2276942210
294849347584, 4555984946, 149866676224, 2278572506, 144982671360, 2276942210
294849347584, 4555984946, 149866676224, 2278572506, 144982671360, 2276942210
296022966272, 4571982503, 151040294912, 2294570063, 144982671360, 2276942210
296022966272, 4571982503, 151040294912, 2294570063, 144982671360, 2276942210
296022966272, 4571982503, 151040294912, 2294570063, 144982671360, 2276942210
296931819520, 4587984731, 151040294912, 2294570063, 145891524608, 2292944438
296931819520, 4587984731, 151040294912, 2294570063, 145891524608, 2292944438
296931819520, 4587984731, 151040294912, 2294570063, 145891524608, 2292944438
298107535360, 4603982383, 152216010752, 2310567715, 145891524608, 2292944438
298107535360, 4603982383, 152216010752, 2310567715, 145891524608, 2292944438
298107535360, 4603982383, 152216010752, 2310567715, 145891524608, 2292944438
298910482432, 4619983908, 152216010752, 2310567715, 146694471680, 2308945963
298910482432, 4619983908, 152216010752, 2310567715, 146694471680, 2308945963
298910482432, 4619983908, 152216010752, 2310567715, 146694471680, 2308945963
300082266112, 4635982329, 153387794432, 2326566136, 146694471680, 2308945963
300082266112, 4635982329, 153387794432, 2326566136, 146694471680, 2308945963
300816793600, 4647984538, 153387794432, 2326566136, 147428999168, 2320948172
301125337088, 4652100055, 153696337920, 2330675311, 147428999168, 2320948172
301125337088, 4652100055, 153696337920, 2330675311, 147428999168, 2320948172
301558398976, 4659991994, 153696337920, 2330675311, 147862061056, 2328834557
301558398976, 4659991994, 153696337920, 2330675311, 147862061056, 2328834557
301558398976, 4659991994, 153696337920, 2330675311, 147862061056, 2328834557
302755086336, 4675982090, 154893025280, 2346665407, 147862061056, 2328834557
302755086336, 4675982090, 154893025280, 2346665407, 147862061056, 2328834557
302755086336, 4675982090, 154893025280, 2346665407, 147862061056, 2328834557
303646638080, 4691983741, 154893025280, 2346665407, 148753612800, 2344836208
303646638080, 4691983741, 154893025280, 2346665407, 148753612800, 2344836208
303646638080, 4691983741, 154893025280, 2346665407, 148753612800, 2344836208
304832839680, 4707982258, 156079226880, 2362663924, 148753612800, 2344836208
304832839680, 4707982258, 156079226880, 2362663924, 148753612800, 2344836208
305258561536, 4715993001, 156079226880, 2362663924, 149179334656, 2352840426
305258561536, 4715993001, 156079226880, 2362663924, 149179334656, 2352840426
305258561536, 4715993001, 156079226880, 2362663924, 149179334656, 2352840426
306157453312, 4731984281, 156079226880, 2362663924, 150078226432, 2368831706
306157453312, 4731984281, 156079226880, 2362663924, 150078226432, 2368831706
306157453312, 4731984281, 156079226880, 2362663924, 150078226432, 2368831706
307353354240, 4747982229, 157275127808, 2378661872, 150078226432, 2368831706
307353354240, 4747982229, 157275127808, 2378661872, 150078226432, 2368831706
307353354240, 4747982229, 157275127808, 2378661872, 150078226432, 2368831706
308201914368, 4763984298, 157275127808, 2378661872, 150926786560, 2384833775
308201914368, 4763984298, 157275127808, 2378661872, 150926786560, 2384833775
308201914368, 4763984298, 157275127808, 2378661872, 150926786560, 2384833775
309382348800, 4779991028, 158455562240, 2394662189, 150926786560, 2384833775
309382348800, 4779991028, 158455562240, 2394662189, 150926786560, 2384833775
309382348800, 4779991028, 158455562240, 2394662189, 150926786560, 2384833775
310280978432, 4795984967, 158455562240, 2394662189, 151825416192, 2400827714
310280978432, 4795984967, 158455562240, 2394662189, 151825416192, 2400827714
310280978432, 4795984967, 158455562240, 2394662189, 151825416192, 2400827714
311466655744, 4811982286, 159641239552, 2410659508, 151825416192, 2400827714
311466655744, 4811982286, 159641239552, 2410659508, 151825416192, 2400827714
311466655744, 4811982286, 159641239552, 2410659508, 151825416192, 2400827714
312060149760, 4823988047, 159641239552, 2410659508, 152418910208, 2412833475
312060149760, 4823988047, 159641239552, 2410659508, 152418910208, 2412833475
312060149760, 4823988047, 159641239552, 2410659508, 152418910208, 2412833475
313286721536, 4839982295, 160867811328, 2426653756, 152418910208, 2412833475
313286721536, 4839982295, 160867811328, 2426653756, 152418910208, 2412833475
314006044672, 4851985175, 160867811328, 2426653756, 153138233344, 2424836355
314006044672, 4851985175, 160867811328, 2426653756, 153138233344, 2424836355
314006044672, 4851985175, 160867811328, 2426653756, 153138233344, 2424836355
315175993344, 4867982223, 162037760000, 2442650804, 153138233344, 2424836355
315175993344, 4867982223, 162037760000, 2442650804, 153138233344, 2424836355
315175993344, 4867982223, 162037760000, 2442650804, 153138233344, 2424836355
316184723456, 4883982125, 162037760000, 2442650804, 154146963456, 2440836257
316184723456, 4883982125, 162037760000, 2442650804, 154146963456, 2440836257
316184723456, 4883982125, 162037760000, 2442650804, 154146963456, 2440836257
317202104320, 4899984795, 163055140864, 2458653474, 154146963456, 2440836257
317202104320, 4899984795, 163055140864, 2458653474, 154146963456, 2440836257
317202104320, 4899984795, 163055140864, 2458653474, 154146963456, 2440836257
318303109120, 4915982167, 163055140864, 2458653474, 155247968256, 2456833629
318303109120, 4915982167, 163055140864, 2458653474, 155247968256, 2456833629
318303109120, 4915982167, 163055140864, 2458653474, 155247968256, 2456833629
319024267264, 4927984423, 163776299008, 2470655730, 155247968256, 2456833629
319024267264, 4927984423, 163776299008, 2470655730, 155247968256, 2456833629
319024267264, 4927984423, 163776299008, 2470655730, 155247968256, 2456833629
320210206720, 4943982183, 163776299008, 2470655730, 156433907712, 2472831389
320210206720, 4943982183, 163776299008, 2470655730, 156433907712, 2472831389
320210206720, 4943982183, 163776299008, 2470655730, 156433907712, 2472831389
321076068352, 4959984218, 164642160640, 2486657765, 156433907712, 2472831389
321076068352, 4959984218, 164642160640, 2486657765, 156433907712, 2472831389
321076068352, 4959984218, 164642160640, 2486657765, 156433907712, 2472831389
322271182848, 4975982121, 164642160640, 2486657765, 157629022208, 2488829292
322271182848, 4975982121, 164642160640, 2486657765, 157629022208, 2488829292
322910814208, 4987984191, 165281792000, 2498659835, 157629022208, 2488829292
322910814208, 4987984191, 165281792000, 2498659835, 157629022208, 2488829292
322910814208, 4987984191, 165281792000, 2498659835, 157629022208, 2488829292
322910814208, 4987984191, 165281792000, 2498659835, 157629022208, 2488829292
324039344128, 5003982049, 165281792000, 2498659835, 158757552128, 2504827150
324039344128, 5003982049, 165281792000, 2498659835, 158757552128, 2504827150
324039344128, 5003982049, 165281792000, 2498659835, 158757552128, 2504827150
324993024000, 5019984085, 166235471872, 2514661871, 158757552128, 2504827150
324993024000, 5019984085, 166235471872, 2514661871, 158757552128, 2504827150
324993024000, 5019984085, 166235471872, 2514661871, 158757552128, 2504827150
326188138496, 5035982202, 166235471872, 2514661871, 159952666624, 2520825267
326188138496, 5035982202, 166235471872, 2514661871, 159952666624, 2520825267
326188138496, 5035982202, 166235471872, 2514661871, 159952666624, 2520825267
326188138496, 5035982202, 166235471872, 2514661871, 159952666624, 2520825267
326188138496, 5035982202, 166235471872, 2514661871, 159952666624, 2520825267
327729020928, 5063984525, 167776354304, 2542664194, 159952666624, 2520825267
327729020928, 5063984525, 167776354304, 2542664194, 159952666624, 2520825267
327729020928, 5063984525, 167776354304, 2542664194, 159952666624, 2520825267
328928067584, 5079982289, 167776354304, 2542664194, 161151713280, 2536823031
328928067584, 5079982289, 167776354304, 2542664194, 161151713280, 2536823031
328928067584, 5079982289, 167776354304, 2542664194, 161151713280, 2536823031
329818308608, 5095985201, 168666595328, 2558667106, 161151713280, 2536823031
330057908224, 5099991330, 168666595328, 2558667106, 161391312896, 2540823143
330057908224, 5099991330, 168666595328, 2558667106, 161391312896, 2540823143
330057908224, 5099991330, 168666595328, 2558667106, 161391312896, 2540823143
331285004288, 5115982031, 168666595328, 2558667106, 162618408960, 2556813844
331285004288, 5115982031, 168666595328, 2558667106, 162618408960, 2556813844
331285004288, 5115982031, 168666595328, 2558667106, 162618408960, 2556813844
332150865920, 5131984529, 169532456960, 2574669604, 162618408960, 2556813844
332150865920, 5131984529, 169532456960, 2574669604, 162618408960, 2556813844
332150865920, 5131984529, 169532456960, 2574669604, 162618408960, 2556813844
332150865920, 5131984529, 169532456960, 2574669604, 162618408960, 2556813844
333347553280, 5147982840, 169532456960, 2574669604, 163815096320, 2572812155
333347553280, 5147982840, 169532456960, 2574669604, 163815096320, 2572812155
333347553280, 5147982840, 169532456960, 2574669604, 163815096320, 2572812155
334234124288, 5163984267, 170419027968, 2590671031, 163815096320, 2572812155
334234124288, 5163984267, 170419027968, 2590671031, 163815096320, 2572812155
334234124288, 5163984267, 170419027968, 2590671031, 163815096320, 2572812155
335423209472, 5179982188, 170419027968, 2590671031, 165004181504, 2588810076
335423209472, 5179982188, 170419027968, 2590671031, 165004181504, 2588810076
336079618048, 5191984009, 171075436544, 2602672852, 165004181504, 2588810076
336079618048, 5191984009, 171075436544, 2602672852, 165004181504, 2588810076
336079618048, 5191984009, 171075436544, 2602672852, 165004181504, 2588810076
