1051721728, 16003062, 226754560, 3938722, 824967168, 11928589
1287651328, 20005304, 462684160, 7913917, 824967168, 11928589
1594359808, 23971054, 462684160, 7913917, 1131675648, 15890973
2011430912, 31987911, 879755264, 15884306, 1131675648, 15890973
2277244928, 35976929, 879755264, 15884306, 1397489664, 19871570
2497183744, 40095131, 1099694080, 19876883, 1397489664, 19980925
2767716352, 43969039, 1099694080, 19876883, 1668022272, 23852309
3251896320, 51975877, 1318060032, 23877819, 1933836288, 27842395
3469737984, 55977081, 1535901696, 27870866, 1933836288, 27842395
3670802432, 59984247, 1736966144, 31863208, 1933836288, 27842395
4167041024, 67976474, 1965555712, 35862210, 2201485312, 31824821
4433641472, 71975298, 1965555712, 35862210, 2468085760, 35815903
4652531712, 75984747, 2184445952, 39857975, 2468085760, 35815903
4926734336, 79969675, 2184445952, 39857975, 2742288384, 39797869
5432410112, 87969531, 2402811904, 43857481, 3029598208, 43788282
5652611072, 91977183, 2623012864, 47857352, 3029598208, 43788282
5873336320, 96090700, 2843738112, 51963453, 3029598208, 43788282
6384779264, 103977567, 3060269056, 55963657, 3324510208, 47664192
6661079040, 107969171, 3060269056, 55963657, 3600809984, 51653130
6882066432, 111975779, 3281256448, 59963277, 3600809984, 51653130
7163609088, 115968952, 3281256448, 59963277, 3882352640, 55643702
7595622400, 123975992, 3713269760, 67957710, 3882352640, 55643702
7852785664, 127969006, 3713269760, 67957710, 4139515904, 59634115
8090025984, 131974387, 3950510080, 71957188, 4139515904, 59634115
8579710976, 139975357, 4162060288, 75957677, 4417650688, 63626064
8848932864, 143969053, 4162060288, 75957677, 4686872576, 67617038
9102950400, 147990988, 4416077824, 79960231, 4686872576, 67617038
9313452032, 151975732, 4626579456, 83939224, 4686872576, 67617038
9815457792, 159975871, 4859887616, 87939050, 4955570176, 71607886
10085203968, 163969048, 4859887616, 87939050, 5225316352, 75598437
10315366400, 167974986, 5090050048, 91938848, 5225316352, 75598437
10823139328, 175974336, 5319950336, 95938701, 5503188992, 79589821
11096817664, 179969069, 5319950336, 95938701, 5776867328, 83581811
11312300032, 183975053, 5535432704, 99938820, 5776867328, 83581811
11527520256, 187974400, 5750652928, 103932583, 5776867328, 83581811
12062556160, 195977210, 6008864768, 107932726, 6053691392, 87573814
12348555264, 199968958, 6008864768, 107932726, 6339690496, 91562987
12567445504, 203974398, 6227755008, 111932399, 6339690496, 91562987
13077577728, 211973909, 6471024640, 115931614, 6606553088, 95554831
13337362432, 215968965, 6471024640, 115931614, 6866337792, 99547327
13573292032, 219974185, 6706954240, 119930954, 6866337792, 99547327
14067695616, 227968483, 6931087360, 123930592, 7136608256, 103539515
14285799424, 231975220, 7149191168, 127925089, 7136608256, 103539515
14551351296, 235969175, 7149191168, 127925089, 7402160128, 107530898
14776795136, 239973558, 7374635008, 131924415, 7402160128, 107530898
15309209600, 247976846, 7622623232, 135924135, 7686586368, 111524306
15580266496, 251968841, 7622623232, 135924135, 7957643264, 115513798
15816982528, 255973942, 7859339264, 139924094, 7957643264, 115513798
16100360192, 259968892, 7859339264, 139924094, 8241020928, 119506240
16586113024, 267968833, 8077967360, 143923353, 8508145664, 123499346
16815226880, 271973472, 8307081216, 147922506, 8508145664, 123499346
17032806400, 275973294, 8524660736, 151917096, 8508145664, 123499346
17531928576, 283973809, 8759279616, 155916347, 8772648960, 127492426
17810063360, 287969036, 8759279616, 155916347, 9050783744, 131484964
18034720768, 291973301, 8983937024, 159915113, 9050783744, 131484964
18587058176, 299975237, 9239265280, 163914897, 9347792896, 135478013
18856542208, 303968787, 9239265280, 163914897, 9617276928, 139469137
19080413184, 307973734, 9463136256, 167914418, 9617276928, 139469137
19295895552, 311973440, 9678618624, 171908752, 9617276928, 139469137
19797901312, 319973958, 9916907520, 175907961, 9880993792, 143462195
20069482496, 323969837, 9916907520, 175907961, 10152574976, 147368237
22540976128, 363973518, 11283464192, 199812708, 11257511936, 163341024
22823567360, 367969283, 11283464192, 199812708, 11540103168, 167334186
23040884736, 371982239, 11500781568, 203813836, 11540103168, 167334186
23549181952, 379973212, 11736711168, 207812501, 11812470784, 171318616
23818141696, 383969007, 11736711168, 207812501, 12081430528, 175311876
24043061248, 387972922, 11961630720, 211811371, 12081430528, 175311876
24575213568, 396043917, 12214599680, 215879559, 12360613888, 179305290
24862785536, 399968962, 12214599680, 215879559, 12648185856, 183227766
25088491520, 403975209, 12440305664, 219879864, 12648185856, 183227766
25295847424, 407973153, 12647661568, 223872671, 12648185856, 183227766
25805979648, 415972741, 12880183296, 227871689, 12925796352, 187220937
26071793664, 419968898, 12880183296, 227871689, 13191610368, 191214513
26304315392, 423976100, 13112705024, 231873690, 13191610368, 191214513
26809466880, 431973124, 13349158912, 235872585, 13460307968, 195204805
27075805184, 435968828, 13349158912, 235872585, 13726646272, 199197875
27305181184, 439972769, 13578534912, 239871425, 13726646272, 199197875
27545042944, 443975917, 13818396672, 243867195, 13726646272, 199197875
28056223744, 451973814, 14045675520, 247866359, 14010548224, 203188386
28334620672, 455968910, 14045675520, 247866359, 14288945152, 207180771
28555870208, 459973293, 14266925056, 251865378, 14288945152, 207180771
29060497408, 467973595, 14482931712, 255864725, 14577565696, 211173737
29330243584, 471968789, 14482931712, 255864725, 14847311872, 215166380
29561192448, 475973182, 14713880576, 259863798, 14847311872, 215166380
29776412672, 479972967, 14929100800, 263858805, 14847311872, 215166380
30278418432, 487973440, 15168700416, 267857499, 15109718016, 219159667
30555766784, 491968909, 15168700416, 267857499, 15387066368, 223152470
30815813632, 495975005, 15428747264, 271856972, 15387066368, 223152470
31325683712, 503974252, 15658385408, 275856261, 15667298304, 227143834
31592284160, 507969049, 15658385408, 275856261, 15933898752, 231136004
31826903040, 511973076, 15893004288, 279855175, 15933898752, 231136004
32094552064, 515968809, 15893004288, 279855175, 16201547776, 235129123
32543866880, 523974291, 16342319104, 287849744, 16201547776, 235129123
32814661632, 527972195, 16342319104, 287849744, 16472342528, 239124430
33041678336, 531973149, 16569335808, 291845405, 16472342528, 239124430
33536081920, 540075884, 16796090368, 295946363, 16739991552, 243117616
33828896768, 543969012, 16796090368, 295946363, 17032806400, 247008200
34069282816, 547973857, 17036476416, 299945503, 17032806400, 247008200
34350039040, 551968768, 17036476416, 299945503, 17313562624, 251000703
34781528064, 559973852, 17467965440, 307940701, 17313562624, 251000703
35063857152, 564072654, 17467965440, 308034920, 17595891712, 254993327
35284320256, 567974107, 17688428544, 311931307, 17595891712, 254993327
35793666048, 575973437, 17919901696, 315923152, 17873764352, 258987053
36072325120, 579968938, 17919901696, 315923152, 18152423424, 262980006
36298031104, 583972675, 18145607680, 319921958, 18152423424, 262980006
36578525184, 587968903, 18145607680, 319921958, 18432917504, 266973675
37044355072, 595975359, 18611437568, 327915990, 18432917504, 266973675
37323538432, 599969140, 18611437568, 327915990, 18712100864, 270964986
37547933696, 603973080, 18835832832, 331915016, 18712100864, 270964986
38055968768, 611973633, 19063373824, 335913941, 18992594944, 274958375
38338297856, 615968880, 19063373824, 335913941, 19274924032, 278951135
38562168832, 619973103, 19287244800, 339912803, 19274924032, 278951135
39053164544, 627969116, 19493289984, 343907387, 19559874560, 282944981
39275724800, 631975945, 19715850240, 347908671, 19559874560, 282944981
39554908160, 635968966, 19715850240, 347908671, 19839057920, 286935355
39799750656, 639975102, 19960692736, 351908157, 19839057920, 286935355
40319582208, 647973862, 20193738752, 355906805, 20125843456, 290926894
40595619840, 651969046, 20193738752, 355906805, 20401881088, 294919305
40820539392, 655973187, 20418658304, 359905693, 20401881088, 294919305
41308389376, 663969070, 20636762112, 363900236, 20671627264, 298913053
41534619648, 667973515, 20862992384, 367898955, 20671627264, 298913053
41823502336, 671968999, 20862992384, 367898955, 20960509952, 302905759
42049994752, 675973003, 21089484800, 371897589, 20960509952, 302905759
42542825472, 683973238, 21309423616, 375896568, 21233401856, 306899027
42790289408, 687976093, 21556887552, 379891764, 21233401856, 306899027
43071045632, 691969099, 21556887552, 379891764, 21514158080, 310889335
43587993600, 699968970, 21798322176, 383890908, 21789671424, 314882178
43803213824, 703973583, 22013542400, 387889939, 21789671424, 314882178
44088164352, 707968810, 22013542400, 387889939, 22074621952, 318874832
44318851072, 711972812, 22244229120, 391889077, 22074621952, 318874832
44813778944, 719973357, 22467051520, 395887730, 22346727424, 322868281
45089816576, 723968775, 22467051520, 395887730, 22622765056, 326861168
45319454720, 727973106, 22696689664, 399886998, 22622765056, 326861168
45801799680, 735970843, 22914007040, 403881749, 22887792640, 330857038
46067613696, 739974888, 23179821056, 407879168, 22887792640, 330857038
46344962048, 743968993, 23179821056, 407879168, 23165140992, 334848632
46562541568, 747973020, 23397400576, 411878396, 23165140992, 334848632
47073460224, 755974104, 23618125824, 415877680, 23455334400, 338842040
47348187136, 759968900, 23618125824, 415877680, 23730061312, 342834277
47574155264, 763972908, 23844093952, 419876685, 23730061312, 342834277
48047063040, 771968827, 24059052032, 423871762, 23988011008, 346827611
48286924800, 775972438, 24298913792, 427870510, 23988011008, 346827611
48562176000, 779968872, 24298913792, 427870510, 24263262208, 350821475
48797843456, 783973364, 24534581248, 431869124, 24263262208, 350821475
49333141504, 791975003, 24779423744, 435868467, 24553717760, 354814436
49622810624, 795968797, 24779423744, 435868467, 24843386880, 358805808
49845108736, 799973302, 25001721856, 439867886, 24843386880, 358805808
50338988032, 807968744, 25217466368, 443862411, 25121521664, 362799468
50568364032, 811973437, 25446842368, 447861764, 25121521664, 362799468
50838372352, 815968833, 25446842368, 447861764, 25391529984, 366792251
51350077440, 823968899, 25684869120, 451860799, 25665208320, 370785964
51572375552, 827973553, 25907167232, 455860170, 25665208320, 370785964
51856015360, 831968920, 25907167232, 455860170, 25948848128, 374778698
52090109952, 836227432, 26141261824, 460112835, 25948848128, 374778698
52580319232, 843968691, 26355171328, 463855450, 26225147904, 378769192
52816248832, 847973810, 26591100928, 467855113, 26225147904, 378769192
53089927168, 851968669, 26591100928, 467855113, 26498826240, 382761597
53605826560, 859968776, 26836467712, 471855736, 26769358848, 386753570
53830221824, 863973881, 27060862976, 475855047, 26769358848, 386753570
54103375872, 867969133, 27060862976, 475855047, 27042512896, 390746119
54338519040, 871973332, 27296006144, 479854244, 27042512896, 390746119
54835281920, 879968789, 27503099904, 483848473, 27332182016, 394739755
55077502976, 883990555, 27745320960, 487851708, 27332182016, 394739755
55387357184, 887969111, 27745320960, 487851708, 27642036224, 398715815
55879401472, 895968953, 27969454080, 491850969, 27909947392, 402708997
56112185344, 899973300, 28202237952, 495850068, 27909947392, 402708997
56382455808, 903968714, 28202237952, 495850068, 28180217856, 406701940
56612880384, 907973155, 28432662528, 499849480, 28180217856, 406701940
57108332544, 915968823, 28643950592, 503844063, 28464381952, 410695310
57336397824, 919973302, 28872015872, 507843009, 28464381952, 410695310
57610076160, 923968671, 28872015872, 507843009, 28738060288, 414688246
58113130496, 931968744, 29094838272, 511841906, 29018292224, 418682213
58378158080, 935975356, 29359865856, 515842244, 29018292224, 418682213
58588397568, 939973260, 29570105344, 519834921, 29018292224, 418682213
58861289472, 943971268, 29570105344, 519834921, 29291184128, 422677640
59371683840, 951968703, 29803675648, 523831766, 29568008192, 426670552
59598438400, 955973884, 30030430208, 527831439, 29568008192, 426670552
59886272512, 959968684, 30030430208, 527831439, 29855842304, 430662894
60380938240, 967968652, 30256136192, 531830708, 30124802048, 434656614
60617654272, 971973000, 30492852224, 535829962, 30124802048, 434656614
60885565440, 976160457, 30760763392, 540011530, 30124802048, 434656614
61112582144, 979968979, 30760763392, 540011530, 30351818752, 438462656
61654433792, 987968794, 31023955968, 544011569, 30630477824, 442453209
61879877632, 991973746, 31249399808, 548010806, 30630477824, 442453209
62180032512, 995968789, 31249399808, 548010806, 30930632704, 446445798
62673649664, 1003968867, 31477989376, 552009696, 31195660288, 450439236
62915346432, 1007973925, 31719686144, 556008946, 31195660288, 450439236
63190859776, 1011968886, 31719686144, 556008946, 31471173632, 454431655
63709904896, 1019968931, 31954042880, 560008165, 31755862016, 458424434
63933513728, 1023973872, 32177651712, 564007477, 31755862016, 458424434
64211386368, 1027968952, 32177651712, 564007477, 32033734656, 462417016
64446529536, 1031973843, 32412794880, 568006092, 32033734656, 462417016
64954826752, 1039968778, 32645054464, 572000177, 32309772288, 466410013
65191280640, 1043973332, 32881508352, 575999393, 32309772288, 466410013
65464434688, 1047968925, 32881508352, 575999393, 32582926336, 470403007
65979285504, 1055968807, 33121107968, 579998104, 32858177536, 474396430
66206040064, 1059972847, 33347862528, 583996996, 32858177536, 474396430
